   #       # #     #       # 
 # # ####### # # ### # ### # 
 #     #   #   # #   # # # # 
#### ### ### ### # # ### # # 
 #       #   #     #   #   # 
 ### ####### # ### ### ### # 
 #           #   # #   #     
 ######### # # # # ### ### ##
         # # # # # # # #     
 # # ##### # # # # # ########
 # #       # # # #   #       
 ### ##### ### ### # # ######
 # #     # #     # #     #   
## # ### # # ### ####### # # 
     # # # # #       #     # 
 # ### # # ### ##### ### # # 
 #   # # # # #     # #   # # 
 ##### # ### ### ####### ### 
   #         #       #   #   
