   #   #     # #   #     # # 
## # # ##### # # ### # ### # 
     # #   # #   # # #       
###### # ### # ### ### # ####
 #           #     #   #   # 
 # ### # ### ### # ##### ### 
 #   # # # # #   #         # 
 ### # # # # ### # ### ##### 
 #   # # #   #   #   #     # 
 ####### ######### ##### ### 
       #       # #     # #   
## ### ####### # ### ### ### 
 # #   # #   # # #   # # # # 
 ### ### # # # # # ### # # # 
 #         #       #   #   # 
 ### # ### # ####### ##### # 
     #   # #         # # # # 
 # ### # ### ### # ### # # # 
 # #   #   #   # #   #       
