       #           #         
## ####### ### ### ##### ### 
         # # #   # # #   #   
 ### ##### # ##### # ### ### 
 #   # # #       #   #     # 
 ### # # # # ######### ##### 
   #       # #   #         # 
 ### ##### # # # ### ########
 # #   #   # # #   # #       
## ##### ### # ##### ### ### 
 # # # #   #     #       #   
 # # # # ### ### ##### ### # 
   #   # #   # #       #   # 
## ### ####### # # ### ######
                 # #   #     
 ####### ### ### # ##### ### 
 #   #   #   # # #         # 
## # ### # ### ### # ### # ##
   #     # #       #   # #   
